1111111111111111111111111111111111111111111111111111111111
1E00000000000000000000C00000000000000000000000000000000001
1010010010101010001001000000010100000000000000000000000001
10100100101010100010010rg000010100000000000000000000000001
1010010010101010001001000000010100000000000000000000000001
1010010010101010001001d00000010100000000000000000000000001
1010010010101010001001000000010100000000000000000000000001
1P0000000000000000000000000000C000000000000000000000000001
1111111111111111111111111111111111111111111111111111111111
