11111111111111111
1P111111111111111
10011111111111111
10000000001111111
11111110111111111
11111110000011111
11111111110111111
1111111111C111111
11111111110111111
1111111111E111111
11111111111111111
